......................................#.............................................................
......................................#.................................###..#.#.##.#...............
......................................#...........................#######.............####..........
......................................#...........##..#.....#....#......#.###............###........
.....................................##..#...#...###..................##........E.........##........
............................####.#..##................................#..................##.........
..........................#.#....................##.#.#.#..##..........###..............##..........
.......................##........................#..........##............##.......###.#............
............#.#.......#..........................#.##.#......#..............##...##.####............
...........#..#........#.#.....................#####.#........##..............##......#.............
..........#..##............#..................#................###..............##....#.............
........#....#...............#............#.#.....................#..#.............##.##............
.......#.....#..............##.........##...............................##......###....###..........
.......#.....##........#..#............#................................##....##..........##........
.......#......#.......#..#.#...........#.#..............................#.....#............#........
.......#......#.............##.............#.#.......................#.#.....#..............#.......
........#....##...............#...............##...................##......#.#.............##.......
........##.....#####..........#...............##...................#....#.#...............##........
.........#..........#........##..............#..............#......##.##..................#.........
.........#...........#.......#..............#................#............................#.........
......#.#...................#................#................#...........................##........
.....#................#....#...................#...............##.......................#..#.##.....
.....#............#....#..#........................#.............##..................#.......#......
.....##..........##.....#.#..........................##...........##................#.....#.........
......#..........#.........#........................###............#.................##.............
.....#...........##.........#......................#...............##................###............
....#.............##..........#......................#..............#######...........#.............
....#..............##..........#.......................#..................#.......#.#...............
....#...............#..........#.........................##.....................##..................
.....##...............#........#..........................#......................#..................
.......#..............##......##.........................#.......................#..................
........#..............###.....#..#.....#......#.....#..........................#...................
........#.................##...............................................#....#...................
........#..................#.................................................#.#.#..................
.......#..................#.....................................................#.#.................
........##................##......##.#.#......................................#....#................
.........##................##....#......###............................#.#.........#................
...........##................#..#........##...............#.##........##..........#.................
............###...............###.......##.#.#.........#.#...##.......###.........#.................
..............##.................................#.#.##.......#.##.#.#............##................
.................#...................................#............................##................
...................#.#..............................###..........................#..................
......................###..............####....................................##...................
.........................#..#.#.#..#.###...#.#.#...#...#.#.##..................##...................
#####........................................................##..#.#####.......##...................
#....###...................................................................#####....................
#......##...........................................................###.##..........................
#........#.....#....................................................................................
##........#....#.................###...##...........................................................
...#.......##.#..............##.##..###.........................................................####
...#.........##...........#.#................................................#.##.########.###.#####
.....#..................#...............................###.#.######################............#...
.....##...............##............................####........................................#...
.......##...........#..........................####..............................................#..
..................###.....................#.####.................................................##.
........#........##..................##.##........................................................#.
.......#............................##......................###.#..##.##.........................#..
......#................................................................#......................#.#...
......#.....................................................................................##......
.....#.......................................................................................#......
.....#.......................................................................................#......
....#...............................................#.......................................#.......
...##.............................................##..#............................###..............
...##.............................................#...##..............................##............
.......................................................#...............................#............
...........................#########...................##......####.#...............................
.....................#...#...........#.#................#......#......#.............................
..................#......................#..............##......#.......#...........................
...............#......#.###.#.##.##.......#..............#......#.........##........................
............##......##......................##...........###.##.###........#........................
............#......#.........................#.............................#........................
..........##........#.......................##...........................##.........................
.........#...........#....................##............................#...........................
.........#............##...........##.###...........................#.#...........###.#.#...........
........#..............#...........##.............................#.......................##........
........#...............##............##.....................#..#..........................#........
........#................##.............#.#.#.#.#.#.#..#.#.#................................#.......
........#..................#................................................................##......
.........##.................####.....................................###..#.#..#.#...........#......
............#......................................................................#.........#......
..............#................#.#.....................#.............................#.......#......
................#.#.................#....................#...#........................#......#......
.......................................#.#.......................#....................#......#......
..........................................#.........................#.................#......#......
.........................................##...........................#........##.....#.....#.......
.......................................##...............................#.......#.....#....#........
######.##.#.##.#.##.##.#............#.#.........................................#....#.....#........
#.......................##.........#.#.#..#..#.#.........................#......#....#....#.........
#........................#................................................#.....#...#....#..........
#........................#................................................#.....#...#....#..........
.#..#####.######.........#................................................#.....####....##..........
.#..............#.........#........................#.....................#.......#......#...........
.#..............#..........#.......................#...................##...............#...........
................#...........##...................##...................#................##...........
...S............#.............#.##.#........#.#.#....................#........#.#...###.............
................#....................#.#.##.........................#............#.#................
...............#..............................................##.####...............................
......................######...........................##.#.#.......................................
.....................#.......#####.#.#..#...#.#.#.###.#.............................................
....................................................................................................
