..........
.########.
.#S..#UE#.
.###.####.
.#......#.
.##.#####.
.#......#.
.#.....U#.
.########.
..........

..........
.########.
.#...#Z.#.
.###.####.
.#......#.
.##.#####.
.#......#.
.#.....Z#.
.########.
..........

..........
.########.
.#...#Z.#.
.###.####.
.#......#.
.##.#####.
.#......#.
.#.....Z#.
.########.
..........

..........
.########.
.#...#Z.#.
.###.####.
.#......#.
.##.#####.
.#......#.
.#.....Z#.
.########.
..........

..........
.########.
.#...#Z.#.
.###.####.
.#......#.
.##.#####.
.#......#.
.#.....Z#.
.########.
..........

..........
.########.
.#...#Z.#.
.###.####.
.#......#.
.##.#####.
.#......#.
.#.....Z#.
.########.
..........

..........
.########.
.#...#Z.#.
.###.####.
.#......#.
.##.#####.
.#......#.
.#.....Z#.
.########.
..........

..........
.########.
.#...#Z.#.
.###.####.
.#......#.
.##.#####.
.#......#.
.#.....Z#.
.########.
..........

..........
.########.
.#...#Z.#.
.###.####.
.#......#.
.##.#####.
.#......#.
.#.....Z#.
.########.
..........

..........
.########.
.#...#Z.#.
.###.##.#.
.#......#.
.##.#####.
.#......#.
.#.....Z#.
.########.
..........
