......#...
.#E.......
....#..#..
.#.#......
......#...
..#.#...#.
.....S....
.#....#...
..........
.....#....
