........................................................................................................................
........................................................................................................................
........................................................................................................................
............................................................................................#...........................
............................................................................................#...........................
............................................................................................#...........................
........................###################################.................................#...........................
........................#.................................#.................................#...........................
........................#.................................#............................############.....................
........................#.................................#.................................#...........................
........................#.................................#.................................#...........................
............####################.######...................#.................................#...........................
............#...........#.............#...................#.................................#...........................
............#...........#.............#...................#.............................................................
............#...........#.............#...................#.............................................................
............#...........#......########...................#.............................................................
............#...........#......#......#.........####.################################. ##...............................
............#....#......#......#......#.........#.........#.............................#...............................
............#....#......##.#...#......#.........#.........#.............................#...............................
............#....#........#...........#.........#.........#.............................#...............................
............#....#......#......#......#.........#.........#.............................#...............................
............#....#......#......#......#.........#.......................................#...............................
............#....#......#.............#.........#.........#............#.#..............#...............................
............#....#......#......#......#.........#.........#............#.#..............#...............................
............#....#......###################################.........#..#.#..............#...............................
............#.........................#.........#...................#..#.#..............#...............................
............#.........................#.........#...................#..#.#..............#...............................
............#.........................#.........#...................#....#..............#...............................
............#......###########........#.........#...................#..#.#..............#...............................
............#.........................#.........#...................#..#.#..............#...............................
............#.....#############.......#.........#...................#..#.#..............#...............................
............#.........................#.........#...E..................#.#..............#...............................
............#.........................#.........#......................#.#..............#...............................
............#.........................#.........#......................#.#..............#...............................
............#.........................#.........#........................#..............#...............................
............#........S................#.........#........................#..............#...............................
............#.........................#.........#.......................................#...............................
............#.........................#.........#.......................................#...............................
............#.........................#.........#.......................................#...............................
............#.........................#.........#.......................................#...............................
............#.........................#.........#########################################...............................
............#.........................#.................................................................................
............###########################.................................................................................
........................................................................................................................
........................................................................................................................
........................................................................................................................
........................................................................................................................
........................................................................................................................
........................................................................................................................
........................................................................................................................
