.........................
..####################...
..#.E.U.....#..U...S.#...
..####################...
.........................

.........................
..####################...
..#...Z.....#..Z.....#...
..####################...
.........................

.........................
..####################...
..#...D........D.....#...
..####################...
.........................
