..........................................................
...###################################################....
...#........................E#S......................#....
...#.................................................#....
...####################.###########.##################....
...#.................................................#....
...####################.###########.##################....
...#.........................#.......................#....
...#.........................#.......................#....
...###################################################....
..........................................................
