........................................................................................................................
.#####################################################################################################################..
.#...#.......#...........#............#...#........#........#..#............#...........#.............#..........#...#..
.#...........#.......#...#...##.......#.......##...##....#.....#............#...........#.........E...#..##......#...#..
.#...........#...........#............#............##..........#............#...........#.............#..............#..
.########.########.###############.######.###############.#########.##############.##########.###############.########..
.#...................................................................................................................#..
.#...................................................................................................................#..
.#######.########################.########.#############.###########.############.############.#############.#########..
.#.....#.....#...........#...........#.............#..........#............#............#.............#..............#..
.#...........#..#........#...##......#..........#..#.#.....#..#...#...#....#...#........#....#........#.#......##....#..
.#.......S...#...........#..........#.....#........#....#.....#............#......#....#.........#....#..............#..
.#...........#...........#......###.#..............#......#...#.......#....#.##........#...#..........#...###........#..
.#####################################################################################################################..
........................................................................................................................
