......................................#.............................................................
......................................#.................................###############.............
......................................#...........................#######.............####..........
......................................#...........##..#.....#....#....#.#.###............###........
.....................................###############..................##........E.........##........
............................##########................................#..................##.........
..........................#.#....................##.#.#.#..##..........###..............##..........
.......................##........................#..........##............##.......###.#............
............###.......#..........................#.##.#......#..............##..#.#.####............
...........#..#........#.#.....................#####.#........##..............##......#.............
..........#..##............#..................#................###..............##....#.............
........#....#...............#............#.#.....................#..#.............#.###............
.......#.....#..............##.........##...............................##......###....###..........
.......#.....##........#..#............#................................##....##..........##........
.......#......#.......#..#.#...........#.#..............................#.....#............#........
.......#......#.............##.............#.#.......................#.#.....#..............#.......
........#....##...............#...............##...................##......#.#.............##.......
........##.....#####..........#...............##...................#....#.#...............##........
.........#..........#........##..............#..............#......##.##..................#.........
.........#...........#.......#..............#................#............................#.........
......#.#...................#................#................#...........................##........
.....#................#....#...................#...............##.......................#..#.##.....
.....#............#....#..#........................#.............##..................#.......#......
.....##..........##.....#.#..........................##...........##................#.....#.........
......#..........#.........#........................###............#.................##.............
.....#...........##.........#......................#...............##................###............
....#.............##..........#......................#..............#######...........#.............
....#..............##..........#.......................#..................#.......#.#...............
....#...............#..........#.........................##.....................##..................
.....##...............#........#..........................#......................#..................
.......#..............##......##.........................#.......................#..................
........#..............###.....#..#.....#......#.....#..........................#...................
........#.................##...............................................#....#...................
........#..................#.................................................#.#.#..................
.......#..................#.....................................................#.#.................
........##................##......######......................................#....#................
.........##................##....#......###............................#.#.........#................
...........##................#..#........##...............#.##........##..........#.................
............###...............###.......##.#.#.........#.#...##.......###.........#.................
..............##.................................#.#.##.......#.##.#.#............##................
.................#...................................#............................##................
...................#.#..............................###..........................#..................
......................###..............####....................................##...................
.........................#..#.#.#..#.###...#.#.#...#...#.#.##..................##...................
#####........................................................##..#.#####.......##...................
#....###...................................................................#####....................
#......##...........................................................###.##..........................
#........#.....#....................................................................................
##........#....#.................###...##...........................................................
...#.......##.#..............##.##..###.........................................................####
...#.........##...........#.#................................................#.##.########.###.#####
.....#..................#...............................###.#.######################............#...
.....##...............##............................####........................................#...
.......##...........#..........................####..............................................#..
..................###.....................#.####.................................................##.
........#........##..................##.##........................................................#.
.......#............................##......................###.#..##.##.........................#..
......#.......S........................................................#......................#.#...
......#.....................................................................................##......
.....#.......................................................................................#......
