..........
.########.
.#S.....#.
.#..#####.
.#..U...#.
.#......#.
.#......#.
.#......#.
.########.
..........

..........
.########.
.#......#.
.#......#.
.#..Z..E#.
.#......#.
.#......#.
.#......#.
.#......#.
..........

..........
.########.
.#......#.
.#......#.
.#..Z...#.
.#......#.
.#......#.
.#......#.
.#......#.
..........
