MAP
1
16, 16, 5
+----------------+
|                |
|                |
|                |
|         ..     |
|         .U===  |
|         ..     |
|                |
|                |
|                |
|                |
|                |
|                |
|                |
|                |
|                |
|                |
+----------------+
|                |
|              ..|
|              ..|
|              ..|
|              ..|
|                |
|                |
|                |
|                |
|                |
|                |
|                |
|                |
|                |
|                |
|                |
+----------------+
|                |
|                |
|                |
|                |
|                |
|                |
|                |
|                |
|                |
|                |
|                |
|                |
|                |
|                |
|                |
|                |
+----------------+
|                |
|                |
|                |
|                |
|                |
|                |
|                |
|                |
|                |
|                |
|                |
|                |
|                |
|                |
|                |
|                |
+----------------+
|                |
|                |
|                |
|                |
|                |
|                |
|                |
|                |
|                |
|                |
|                |
|                |
|                |
|                |
|                |
|                |
+----------------+
