MAP
1
16, 16, 5
+----------------+
|                |
|                |
|                |
| ######WWW###   |
| ............   |
| .WWWWWWWWWW.   |
| .....W......   |
| .....W......   |
| .....W......   |
| .....W......   |
| ..WWWWWWW...   |
| .....W......   |
| .....W......   |
| .WWWWWWWWWW.   |
| ............   |
|                |
+----------------+
|                |
|                |
|                |
|                |
|                |
|                |
|                |
|                |
|                |
|                |
|                |
|                |
|                |
|                |
|                |
|                |
+----------------+
|                |
|                |
|                |
|                |
|                |
|                |
|                |
|                |
|                |
|                |
|                |
|                |
|                |
|                |
|                |
|                |
+----------------+
|                |
|                |
|                |
|                |
|                |
|                |
|                |
|                |
|                |
|                |
|                |
|                |
|                |
|                |
|                |
|                |
+----------------+
|                |
|                |
|                |
|                |
|                |
|                |
|                |
|                |
|                |
|                |
|                |
|                |
|                |
|                |
|                |
|                |
+----------------+
