MAP
1
16, 16, 5
+----------------+
|                |
|                |
|                |
| ######WWW###   |
| ............   |
| .U===.===U..   |
| ............   |
| .S===.===S..   |
| ............   |
| .D===.===D..   |
| ............   |
| ............   |
| .WWWWWWWWW..   |
| ............   |
|                |  .
|                |
+----------------+
|                |
|                |
|                |
|                |
|                |
|      .         |
|      .         |
|      .         |
|      .         |
|      .         |
|                |
|                |
|                |
|                |
|                |
|                |
+----------------+
|                |
|                |
|                |
|                |
|                |
|                |
|                |
|                |
|                |
|                |
|                |
|                |
|                |
|                |
|                |
|                |
+----------------+
|                |
|                |
|                |
|                |
|                |
|                |
|                |
|                |
|                |
|                |
|                |
|                |
|                |
|                |
|                |
|                |
+----------------+
|                |
|                |
|                |
|                |
|                |
|                |
|                |
|                |
|                |
|                |
|                |
|                |
|                |
|                |
|                |
|                |
+----------------+
