MAP
1
16, 16, 5
+----------------+
|                |
|                |
|                |
| ######WWW###   |
| ............   |
| ........L...   |
| .=..........   |
| .=..........   |
| .=..........   |
| .S..........   |
| ............   |
| ............   |
| .S===.===U..   |
| ............   |
|                |
|                |
+----------------+
|                |
|                |
|                |
|                |
|                |
|  ..     Z      |
|                |
|                |
|                |
|                |
|                |
|                |
|      .         |
|                |
|                |
|                |
+----------------+
|                |
|                |
|                |
|                |
|                |
|         l      |
|                |
|                |
|                |
|                |
|                |
|                |
|                |
|                |
|                |
|                |
+----------------+
|                |
|                |
|                |
|                |
|                |
|                |
|                |
|                |
|                |
|                |
|                |
|                |
|                |
|                |
|                |
|                |
+----------------+
|                |
|                |
|                |
|                |
|                |
|                |
|                |
|                |
|                |
|                |
|                |
|                |
|                |
|                |
|                |
|                |
+----------------+
