MAP
1
16, 16, 5
+----------------+
|                |
|      = =       |
|      = =       |
|  ....=.=...    |
|  ....D.U...    |
|  ..........    |
|  ===U....U===  |
|  ..........    |
|  ===D....D===  |
|  ..........    |
|  U........D    |
|  =        =    |
|  =        =    |
|  =        =    |
|                |
|                |
+----------------+
|................|
|..            ..|
|..            ..|
|..            ..|
|..            ..|
|..            ..|
|..            ..|
|..            ..|
|..            ..|
|..            ..|
|..            ..|
|..            ..|
|..            ..|
|..            ..|
|...         ....|
|...         ....|
+----------------+
|                |
|                |
|                |
|                |
|                |
|                |
|                |
|                |
|                |
|                |
|                |
|                |
|                |
|                |
|                |
|                |
+----------------+
|                |
|                |
|                |
|                |
|                |
|                |
|                |
|                |
|                |
|                |
|                |
|                |
|                |
|                |
|                |
|                |
+----------------+
|                |
|                |
|                |
|                |
|                |
|                |
|                |
|                |
|                |
|                |
|                |
|                |
|                |
|                |
|                |
|                |
+----------------+
