MAP
1
16, 16, 5
+----------------+
|                |
|                |
|                |
| ######WWW###   |
| ............   |
| .U===.===D..   |
| ............   |
| ...S..U..D..   |
| ...=..=..=..   |
| ...=..=..=..   |
| ...=..=..=..   |
| ............   |
| .D===.===U..   |
| ............   |
|                |
|                |
+----------------+
|                |
|                |
|                |
|                |
|                |
|                |
|                |
|                |
|                |
|                |
|                |
|                |
|                |
|                |
|                |
|                |
+----------------+
|                |
|                |
|                |
|                |
|                |
|                |
|                |
|                |
|                |
|                |
|                |
|                |
|                |
|                |
|                |
|                |
+----------------+
|                |
|                |
|                |
|                |
|                |
|                |
|                |
|                |
|                |
|                |
|                |
|                |
|                |
|                |
|                |
|                |
+----------------+
|                |
|                |
|                |
|                |
|                |
|                |
|                |
|                |
|                |
|                |
|                |
|                |
|                |
|                |
|                |
|                |
+----------------+
