MAP
1
16, 16, 5
+----------------+
|                |
|                |
|                |
| ######WWW###   |
| ............   |
| .....WWWWWW.   |
| .....W......   |
| .....W......   |
| .....W......   |
| .....W......   |
| ..########..   |
| ....===.....   |
| #...===.....   |
| #...===.....   |
| ....DUU.....   |
| ............   |
+----------------+
|                |
|                |
|                |
|                |
|                |
|                |
|                |
|                |
|  .........     |
|  .........     |
|   ........     |
|                |
|                |
|                |
|                |
|                |
+----------------+
|                |
|                |
|                |
|                |
|                |
|                |
|                |
|                |
|                |
|                |
|                |
|                |
|                |
|                |
|                |
|                |
+----------------+
|                |
|                |
|                |
|                |
|                |
|                |
|                |
|                |
|                |
|                |
|                |
|                |
|                |
|                |
|                |
|                |
+----------------+
|                |
|                |
|                |
|                |
|                |
|                |
|                |
|                |
|                |
|                |
|                |
|                |
|                |
|                |
|                |
|                |
+----------------+
