MAP
1
16, 16, 6
+----------------+
|................|
|.#####    #####.|
|.#............#.|
|.#............#.|
|.#............#.|
|.#............#.|
|.#............#.|
|. ....S===.... .|
|. ....===S.... .|
|.#............#.|
|.#............#.|
|.#............#.|
|.#............#.|
|.#............#.|
|.#............#.|
|................|
+----------------+
|                |
| #####    ##### |
| #............# |
| #............# |
| #..        ..# |
| #..        ..# |
| #..        ..# |
|  ....S===....  |
|  ....===S....  |
| #..        ..# |
| #..        ..# |
| #..        ..# |
| #..        ..# |
| #..        ..# |
| #..        ..# |
|                |
+----------------+
|                |
| #####    ##### |
| #............# |
| #............# |
| #..        ..# |
| #..        ..# |
| #..        ..# |
|  ....S===....  |
|  ....===S....  |
| #..        ..# |
| #..        ..# |
| #..        ..# |
| #..        ..# |
| #..        ..# |
| #..        ..# |
|                |
+----------------+
|                |
| #####    ##### |
| #............# |
| #............# |
| #..        ..# |
| #..        ..# |
| #..        ..# |
|  ....S===....  |
|  ....===S....  |
| #..        ..# |
| #..        ..# |
| #..        ..# |
| #..        ..# |
| #..        ..# |
| #..        ..# |
|                |
+----------------+
|                |
| ####     ##### |
| #............# |
| #............# |
| #..        ..# |
| #..        ..# |
| #..        ..# |
|  ....S===....  |
|  ....===S....  |
| #..        ..# |
| #..        ..# |
| #..        ..# |
| #..        ..# |
| #..        ..# |
| #..        ..# |
|                |
+----------------+                                                      .
|                |
| ############## |
| #............# |
| #............# |
| #..        ..# |
| #..        ..# |
| #..        ..# |
|  ....S===....  |
|  ....===S....  |
| #..        ..# |
| #..        ..# |
| #..        ..# |
| #..        ..# |
| #..        ..# |
| #..        ..# |
|                |
+----------------+
