MAP
1
16, 16, 6
+----------------+
|................|
|.##############.|
|.#............#.|
|.#............#.|
|.#............#.|
|.#....U===....#.|
|.#............#.|
|.#............#.|
|.#............#.|
|.#............#.|
|.#............#.|
|.#............#.|
|.#............#.|
|.#............#.|
|.#............#.|
|................|
+----------------+
|                |
| ############## |
| #............# |
| #..        ..# |
| #..        ..# |
| #..      ....# |
| #..      U ..# |
| #..      = ..# |
| #..      = ..# |
| #..      = ..# |
| #..        ..# |
| #..        ..# |
| #..        ..# |
| #............# |
| #..        ..# |
|                |
+----------------+
|                |
| ############## |
| #..        ..# |
| #..        ..# |
| #..        ..# |
| #..        ..# |
| #..        ..# |
| #..        ..# |
| #..        ..# |
| #..      ....# |
| #..  ===U....# |
| #..      ....# |
| #..        ..# |
| #..        ..# |
| #............# |
|                |
+----------------+
|                |
| ############## |
| #..        ..# |
| #..        ..# |
| #..        ..# |
| #..        ..# |
| #.. =      ..# |
| #.. =      ..# |
| #.. =      ..# |
| #.. U      ..# |
| #....      ..# |
| #..        ..# |
| #..        ..# |
| #..        ..# |
| #..        ..# |
|                |
+----------------+
|                |
| ############## |
| #..        ..# |
| #..        ..# |
| #..        ..# |
| #....U===  ..# |
| #..        ..# |
| #..        ..# |
| #..        ..# |
| #..        ..# |
| #..        ..# |
| #..        ..# |
| #..        ..# |
| #..        ..# |
| #..        ..# |
|                |
+----------------+
|                |
| ############## |
| #............# |
| #..        ..# |
| #..        ..# |
| #..      ....# |
| #..        ..# |
| #..        ..# |
| #..        ..# |
| #..        ..# |
| #..        ..# |
| #..        ..# |
| #..        ..# |
| #..        ..# |
| #..        ..# |
|                |
+----------------+
