MAP
1
30, 30, 5
+------------------------------+
|..............................|
|..............................|
|..............................|
|...########################...|
|...#......................#...|
|...#......................#...|
|...#......................#...|
|...#......................#...|
|...#......................#...|
|...#......................#...|
|...#......................#...|
|...#......................#...|
|...#......................#...|
|...#......................#...|
|...###..................###...|
|...#......................#...|
|...#......................#...|
|...#......................#...|
|...#......................#...|
|...#......................#...|
|...#......................#...|
|...#......................#...|
|...#......................#...|
|...#......................#...|
|...#......................#...|
|...#..........Z...........#...|
|...###..................###...|
|..............................|
|..............................|
|..............................|
+------------------------------+
|##                            |
|##                            |
|  #                           |
|   ######################     |
|   #....................#     |
|   #....................#     |
|   #....................#     |
|   #....................#     |
|   #....................#     |
|   #....................#     |
|   #....................#     |
|   #....................#     |
|   #....................#     |
|   #....................#     |
|   #....................#     |
|   #....................#     |
|   #....................#     |
|   #....................#     |
|   #....................#     |
|   #....................#     |
|   #....................#     |
|   #....................#     |
|   #....................#     |
|   #....................#     |
|   #....................#     |
|   ##.........Z........##     |
|                              |
|                              |
|                              |
|                              |
+------------------------------+
|                              |
|                              |
|                              |
|   ########################   |
|   #......................#   |
|   #......................#   |
|   #......................#   |
|   #......................#   |
|   #......................#   |
|   #......................#   |
|   #......................#   |
|   #......................#   |
|   #......................#   |
|   #......................#   |
|   #......................#   |
|   #......................#   |
|   #......................#   |
|   #......................#   |
|   #......................#   |
|   #......................#   |
|   #......................####|
|   #......................#   |
|   #......................#   |
|   #......................#   |
|   #......................#   |
|   #......................#   |
|   ##......... ..........##   |
|                              |
|                              |
|                              |
+------------------------------+
|                              |
|                              |
|                              |
|  #########################   |
|  #.......................#   |
|  #.......................#   |
|  #.......................#   |
|  #.......................#   |
|  #.......................#   |
|  #.......................#   |
|  #.......................#   |
|  #.......................#   |
|  #.......................#   |
|  #.......................#   |
|  #.......................#   |
|  #.......................#   |
|  #.......................#   |
|  #.......................#   |
|  #.......................#   |
|  #.......................#   |
|  #.......................#   |
|  #.......................#   |
|  #.......................#   |
|  #.......................#   |
|  #.......................#   |
|  #.......................#   |
|  #.......................#   |
|  ##.....................##   |
|                              |
|                              |
+------------------------------+
|                              |
|                              |
|                              |
|  ##########################  |
|  #........................#  |
|  #........................#  |
|  #........................#  |
|  #........................#  |
|  #........................#  |
|  #........................#  |
|  #........................#  |
|  #........................#  |
|  #........................#  |
|  #........................#  |
|  #........................#  |
|  #........................#  |
|  #........................#  |
|  #........................#  |
|  #........................#  |
|  #........................#  |
|  #........................#  |
|  #........................#  |
|  #........................#  |
|  #........................#  |
|  #........................#  |
|  #........................#  |
|  #........................#  |
|  #........................#  |
|  ##.....................###  |
|                              |
+------------------------------+
