MAP
1
70, 5, 10
+----------------------------------------------------------------------+
|######################################################################|
|#.........W.....W.....W.....W........W.....W....W.....W......W.......#|
|#.........W.....W.....W.....W........W.....W....W.....W......W.......#|
|#WWWW.WWWWWWW.WWWWW.WWWWW.WWW..U===..WWW.WWWWW.WWWW.WWWWWW.WWWWWW.WWW#|
|#..............................===U..................................#|
+----------------------------------------------------------------------+
|######################################################################|
|#.........W.....W.....W.....W........W.....W....W.....W......W.......#|
|#.........W.....W.....W.....W........W.....W....W.....W......W.......#|
|#WWWW.WWWWWWW.WWWWW.WWWWW.WWW..U===..WWW.WWWWW.WWWW.WWWWWW.WWWWWW.WWW#|
|#..............................===U..................................#|
+----------------------------------------------------------------------+
|######################################################################|
|#.........W.....W.....W.....W........W.....W....W.....W......W.......#|
|#.........W.....W.....W.....W........W.....W....W.....W......W.......#|
|#WWWW.WWWWWWW.WWWWW.WWWWW.WWW..U===..WWW.WWWWW.WWWW.WWWWWW.WWWWWW.WWW#|
|#..............................===U..................................#|
+----------------------------------------------------------------------+
|######################################################################|
|#.........W.....W.....W.....W........W.....W....W.....W......W.......#|
|#.........W.....W.....W.....W........W.....W....W.....W......W.......#|
|#WWWW.WWWWWWW.WWWWW.WWWWW.WWW..U===..WWW.WWWWW.WWWW.WWWWWW.WWWWWW.WWW#|
|#..............................===U..................................#|
+----------------------------------------------------------------------+
|######################################################################|
|#.........W.....W.....W.....W........W.....W....W.....W......W.......#|
|#.........W.....W.....W.....W........W.....W....W.....W......W.......#|
|#WWWW.WWWWWWW.WWWWW.WWWWW.WWW..U===..WWW.WWWWW.WWWW.WWWWWW.WWWWWW.WWW#|
|#..............................===U..................................#|
+----------------------------------------------------------------------+
|######################################################################|
|#.........W.....W.....W.....W........W.....W....W.....W......W.......#|
|#.........W.....W.....W.....W........W.....W....W.....W......W.......#|
|#WWWW.WWWWWWW.WWWWW.WWWWW.WWW..U===..WWW.WWWWW.WWWW.WWWWWW.WWWWWW.WWW#|
|#..............................===U..................................#|
+----------------------------------------------------------------------+
|######################################################################|
|#.........W.....W.....W.....W........W.....W....W.....W......W.......#|
|#.........W.....W.....W.....W........W.....W....W.....W......W.......#|
|#WWWW.WWWWWWW.WWWWW.WWWWW.WWW..U===..WWW.WWWWW.WWWW.WWWWWW.WWWWWW.WWW#|
|#..............................===U..................................#|
+----------------------------------------------------------------------+
|######################################################################|
|#.........W.....W.....W.....W........W.....W....W.....W......W.......#|
|#.........W.....W.....W.....W........W.....W....W.....W......W.......#|
|#WWWW.WWWWWWW.WWWWW.WWWWW.WWW..U===..WWW.WWWWW.WWWW.WWWWWW.WWWWWW.WWW#|
|#..............................===U..................................#|
+----------------------------------------------------------------------+
|######################################################################|
|#.........W.....W.....W.....W........W.....W....W.....W......W.......#|
|#.........W.....W.....W.....W........W.....W....W.....W......W.......#|
|#WWWW.WWWWWWW.WWWWW.WWWWW.WWW..U===..WWW.WWWWW.WWWW.WWWWWW.WWWWWW.WWW#|
|#..............................===U..................................#|
+----------------------------------------------------------------------+
|######################################################################|
|#.........W.....W.....W.....W........W.....W....W.....W......W.......#|
|#.........W.....W.....W.....W........W.....W....W.....W......W.......#|
|#WWWW.WWWWWWW.WWWWW.WWWWW.WWW..    ..WWW.WWWWW.WWWW.WWWWWW.WWWWWW.WWW#|
|#..............................    ..................................#|
+----------------------------------------------------------------------+
