MAP
1
16, 16, 1
+---------------------+
|.....................|
|.##############......|
|.#............#......|
|.#............#......|
|.#............#......|
|.#............#......|
|.#............#......|
|.#....U===....#......|
|.#....===U....#......|
|.#............#......|
|.#............#......|
|.#............#......|
|.#............#......|
|.#............#......|
|.#............#......|
|.....................|
+---------------------+
