MAP
1
30, 30, 5
+------------------------------+
|     ........#................|
|     ........#................|
|     ........#................|
|     ........#................|
|     ..S===..#..........===S..|
|     ........#............    |
|     ........#............    |
|     ........#............    |
|     ........#............    |
|     ........#............    |
|     ........#............    |
|     ........#............    |
|     ........#............    |
|     ........#............    |
|     ........#..=.........    |
|    ===S.....#..=.........    |
|    .........#..=.........    |
|    .........#..S.........    |
|    .........#........S===    |
|    .........#............    |
|                              |
|                              |
|                              |
|                              |
|                              |
|                              |
|                              |
|                              |
|                              |
|                              |
+------------------------------+
|           ..............     |
|           ..............     |
|           ..............     |
|                 ..           |
|           S===  .. ===S      |
|                 ..           |
|                 ..           |
|  .................           |
|  ..........................  |
|  ..                      ..  |
|  ..            =         ..  |
|  ..            =         ..  |
|  ..            =         ..  |
|  ..            S         ..  |
|....                      ..  |
|....                      ..  |
|....                      ..  |
|....                      ....|
|....                      ....|
|                          ....|
|                          ....|
|                              |
|                              |
|                              |
|                              |
|                              |
|                              |
|                              |
|                              |
|                              |
+------------------------------+
|                              |
|                              |
|                              |
|               .....          |
|               .....          |
|               .....          |
|               .....          |
|               .....          |
|               .....          |
|               .....          |
|                              |
|                              |
|                              |
|                              |
|                              |
|                              |
|                              |
|                              |
|                              |
|                              |
|                              |
|                              |
|                              |
|                              |
|                              |
|                              |
|                              |
|                              |
|                              |
|                              |
+------------------------------+
|                              |
|                              |
|                              |
|                              |
|                              |
|                              |
|                              |
|                              |
|                              |
|                              |
|                              |
|                              |
|                              |
|                              |
|                              |
|                              |
|                              |
|                              |
|                              |
|                              |
|                              |
|                              |
|                              |
|                              |
|                              |
|                              |
|                              |
|                              |
|                              |
|                              |
+------------------------------+
|                              |
|                              |
|                              |
|                              |
|                              |
|                              |
|                              |
|                              |
|                              |
|                              |
|                              |
|                              |
|                              |
|                              |
|                              |
|                              |
|                              |
|                              |
|                              |
|                              |
|                              |
|                              |
|                              |
|                              |
|                              |
|                              |
|                              |
|                              |
|                              |
|                              |
+------------------------------+
