MAP
1
6, 6, 2
+------+
|......|
|.=..=.|
|.=..=.|
|.=..=.|
|.U..D.|
|......|
+------+
|......|
|. .. .|
|      |
|      |
|      |
|      |
+------+
