MAP
1
70, 70, 1
+----------------------------------------------------------------------+
|..#.......#..#........................................................|
|..#.......#..#........................................................|
|..#.......#..#........................................................|
|..#...#...#..#........................................................|
|..#...#...#..#........................................................|
|..#...#...#..#.....................#..................................|
|......#.#.#.......................#...................................|
|#######.#.#..#...................#....................................|
|........#....#..................#.....................................|
|################................#.....................................|
|........#....#.................#.........#............................|
|........#....#................#.........#.............................|
|........########################.......#..............................|
|........#....#..............#...######################................|
|........#....#.............#..........#...............................|
|........#....#.............#.........#................................|
|........#....#............#.........#.................................|
|........#....#...........#.........#..................................|
|........#....#....#.....#.........#...................................|
|........#....#.....#...#..........#...................................|
|........#....#......#.#..........#....................................|
|........#............##.........#.....................................|
|........#............##........#......................................|
|........#...........#..#......#.......................................|
|........#..........#....#....#.........................###############|
|........#................#...#...........##############...............|
|........#.................#.#.....................#...................|
|........#..................#......................#...................|
|........#.................#.#......................#..................|
|........#....................#.....................#..................|
|........#.....................#................#....#.................|
|........#......................##............##.....#.................|
|........#........................#.........##........#................|
|........#.........................#......##..........#................|
|........#..........................#...##.............#...............|
|........#...........................###...............................|
|........#..........................###............#...................|
|........#........................##...#..........#....................|
|........#......................##......#.......##.....................|
|........##...................##.........#.....#.......................|
|........##.................##............#...#........................|
|........##...............##...............###.........................|
|........##.............##.................##........................##|
|........##...........##..................#..#...................####..|
|........##.........##..................##....#..............####......|
|........##........#...................#.......#..........###..........|
|........##...........................#...............####.............|
|........#..........................##..............##.................|
|........#.........................#...................................|
|........#........................#....................................|
|........#......................##.....................................|
|........#.....................#.........................##############|
|........#....................#...........###############..............|
|........#......................................###....................|
|...........................................####.......................|
|.......................................####...........................|
|..................................#####...............................|
|..............................####....................................|
|.........................#####........................................|
|.....................####.............................................|
|.................####.................................................|
|..............###.....................................................|
|......................................................................|
|......................................................................|
|......................................................................|
|......................................................................|
|......................................................................|
|......................................................................|
|......................................................................|
|......................................................................|
+----------------------------------------------------------------------+
