MAP
1
6, 6, 2
+------+
|......|
|.=..=.|
|.=..=.|
|.=..=.|
|.S..U.|
|......|
+------+
|......|
|. .   |
|      |
|      |
|      |
|      |
+------+
