MAP
1
6, 4, 2
+------+
|......|
|......|
|.U===#|
|......|
+------+
|      |
|      |
|     .|
|      |
+------+
