MAP
1
10, 10, 3
+----------+
|..........|
|.########.|
|.#.#....#.|
|.#.#....#.|
|.#.#L...#.|
|.#.#....#.|
|.#.#....#.|
|.#.#....#.|
|.#......#.|
|..........|
+----------+
|          |
| ######## |
| #......# |
| #......# |
| #..l...# |
| #.#.#### |
| #......# |
| #.....L# |
| #......# |
|          |
+----------+
|          |
| ######## |
| #..#...# |
| #..#.#.# |
| #..#.#.# |
| #..#.#.# |
| #..#.#.# |
| #..#.#l# |
| #....#.# |
|          |
+----------+
