MAP
1
10, 10, 3
+----------+
|..........|
|.########.|
|.#.#....#.|
|.#.#....#.|
|.#.#S...#.|
|.#.#....#.|
|.#.#....#.|
|.#.#....#.|
|.#......#.|
|..........|
+----------+
|          |
| ######## |
| #......# |
| #......# |
| #..E...# |
| #.#.#### |
| #......# |
| #.....S# |
| #......# |
|          |
+----------+
|          |
| ######## |
| #..#...# |
| #..#.#.# |
| #..#.#.# |
| #..#.#.# |
| #..#.#.# |
| #..#.#E# |
| #....#.# |
|          |
+----------+
