MAP
1
32, 32, 5
+--------------------------------+
|................................|
|.##############################.|
|.#......#.............#.......#.|
|.#......#.............#.......#.|
|.#......#.............#.......#.|
|.#..S...#.....U.......#....S..#.|
|.#......#.....=.......#.......#.|
|.#......#.....=.......#.......#.|
|.#............=...............#.|
|.#............................#.|
|.#............................#.|
|.#............................#.|
|.#............................#.|
|.#............................#.|
|.#............................#.|
|.#..........=..=..............#.|
|.#..........=..=..............#.|
|.#..........=..=..............#.|
|.#..........U..U..............#.|
|.#............................#.|
|.#............................#.|
|.#............................#.|
|.#............................#.|
|.#............................#.|
|.#..WWWWWWWWWWW....WWW........#.|
|.#............................#.|
|.#..................WW........#.|
|.#................WWW.........#.|
|.#............................#.|
|.#............................#.|
|.#............................#.|
|................................|
+--------------------------------+
|                                |
| ########             ######### |
| #......#             #.......# |
| #......#             #.......# |
| #......#             #.......# |
| #..Z...#             #....Z..# |
| #......#    . ..     #.......# |
| #......#  .......    #.......# |
|           .......           .  |
|           .......           .  |
|           .......           .  |
|        ===U.....U===        .  |
|           .......           .  |
|           .......           .  |
|           .......              |
|           . .. ..              |
|                                |
|                                |
|                                |
|                                |
|                                |
|                                |
|                                |
|                                |
|                                |
|                                |
|                                |
|                                |
|                                |
|                                |
|                                |
|                                |
+--------------------------------+
|                                |
| ############################## |
| #............................# |
| #............................# |
| #............................# |
| #..Z......................Z..# |
| #............................# |
| #............................# |
|       .             .          |
|       .             .          |
|       ..           ..          |
|       .             .          |
|       ..           ..          |
|       .             .          |
|       .             .          |
|       .             .          |
|                                |
|                                |
|                                |
|                                |
|                                |
|                                |
|                                |
|                                |
|                                |
|                                |
|                                |
|                                |
|                                |
|                                |
|                                |
|                                |
+--------------------------------+
|                                |
| ############################## |
| #............................# |
| #............................# |
| #............................# |
| #..Z......................Z..# |
| #............................# |
| #............................# |
|                                |
|                                |
|                                |
|                                |
|                                |
|                                |
|                                |
|                                |
|                                |
|                                |
|                                |
|                                |
|                                |
|                                |
|                                |
|                                |
|                                |
|                                |
|                                |
|                                |
|                                |
|                                |
|                                |
|                                |
+--------------------------------+
|                                |
| ############################## |
| #............................# |
| #............................# |
| #............................# |
| #..Z......................Z..# |
| #............................# |
| #............................# |
|                                |
|                                |
|                                |
|                                |
|                                |
|                                |
|                                |
|                                |
|                                |
|                                |
|                                |
|                                |
|                                |
|                                |
|                                |
|                                |
|                                |
|                                |
|                                |
|                                |
|                                |
|                                |
|                                |
|                                |
+--------------------------------+
