MAP
1
32, 32, 3
+--------------------------------+
|................................|
|.##############################.|
|.#......#.............#.......#.|
|.#......#.............#.......#.|
|.#......#.............#.......#.|
|.#..S...#.............#....S..#.|
|.#......#.............#.......#.|
|.#......#.............#.......#.|
|.#............................#.|
|.#............................#.|
|.#............................#.|
|.#............................#.|
|.#............................#.|
|.#............................#.|
|.#............................#.|
|.#............................#.|
|.#............................#.|
|.#............................#.|
|.#............................#.|
|.#............................#.|
|.#............................#.|
|.#............................#.|
|.#............................#.|
|.#............................#.|
|.#............................#.|
|.#............................#.|
|.#............................#.|
|.#............................#.|
|.#............................#.|
|.#............................#.|
|.#............................#.|
|................................|
+--------------------------------+
|                                |
| ########             ######### |
| #......#             #.......# |
| #......#             #.......# |
| #......#             #.......# |
| #..Z...#             #....Z..# |
| #......#             #.......# |
| #......#             #.......# |
|                                |
|                                |
|                                |
|                                |
|                                |
|                                |
|                                |
|                                |
|                                |
|                                |
|                                |
|                                |
|                                |
|                                |
|                                |
|                                |
|                                |
|                                |
|                                |
|                                |
|                                |
|                                |
|                                |
|                                |
+--------------------------------+
|                                |
| ############################## |
| #............................# |
| #............................# |
| #............................# |
| #..Z......................Z..# |
| #............................# |
| #............................# |
|                                |
|                                |
|                                |
|                                |
|                                |
|                                |
|                                |
|                                |
|                                |
|                                |
|                                |
|                                |
|                                |
|                                |
|                                |
|                                |
|                                |
|                                |
|                                |
|                                |
|                                |
|                                |
|                                |
|                                |
+--------------------------------+
