................#..............................
................#..............................
................#..............................
................#..............................
..###############..............................
..#............................................
..#.#############..............................
..#.#...........#..............................
..#.#.#########.#..............................
..#.#.#E......#.#..............................
..#.#.........#.#..............................
..#.###########.#..............................
..#.............#.S............................
..###############..............................
................#..............................
